S, , , , , , , , , 
 , , , , , , , , ,D
 , , , , , , , , , 
 , , , , , , , , , 
X, , ,X, , ,X, , ,X
X, , ,X, , ,X, , ,X
X, , ,X, , ,X, , ,X
X, , ,X, , ,X, , ,X
X,P, ,X,P, ,X,P, ,X
X, , ,X, , ,X, , ,X