 , , , , , , , 
S, , , , , , ,D
S, , , , , , , 
 , , , , , , , 
X, , ,X, , ,X, 
X, , ,X, , ,X, 
X, , ,X, , ,X, 
X, , ,X, , ,X, 
X,P, ,X,P, ,X, 
X, , ,X, , ,X, 