 , , ,D, , , ,S, , 
 , , , , , , , , ,S
S, , , , , , , , , 
 , , , , , , , , , 
X, , ,X, , ,X, , ,X
X, , ,X, , ,X,P, ,X
X,P, ,X, , ,X, , ,X
X, , ,X, , ,X, , ,X
X, , ,X,P, ,X, , ,X
X, , ,X, , ,X, , ,X